7  12
--P---------
------------
S-----HS----
------------
--C----V----
------------
S-C---HS----
